1111111111111111111111
10000110000000110C0001
1011111111111011000001
1P00000000000110000011
100C00E000C00011011001
110000C001111011000001
11100011011110110C0001
1000000000001000000001
10C01100C00101100C0001
1111111111111111111111