111111
100C01
110111
1P00E1
111111
