1111111
1P000C1
1110101
1C00101
1011101
10000E1
1111111