11111111111111111
1P0000000000000C1
10111101111001001
10000101000001001
11110101011101001
1C000010100010001
10111111010111101
10000000010000001
10111111110111101
100000100000000E1
11111010111011101
100C1010000010001
10101011111110101
1C000000000000001
11111111111111111
