11111
1P0C1
10001
1C0E0
11111

11111
100C1
10001
1C000
11111