111111
1P0C11
111111
1C0011
1110E1
111111